20
8
1 1 1 1 1 1 1 1 1 1 1 1 1 1 1 1 1 1 1 1
1 0 0 0 0 0 0 0 0 0 0 0 0 0 0 0 0 0 0 1
1 0 0 0 0 0 0 0 0 0 0 0 0 0 0 0 0 0 0 1
1 0 1 0 0 0 0 0 0 0 0 0 0 0 0 0 0 0 9 1
1 0 0 0 0 0 0 0 0 0 0 0 0 0 0 0 0 0 1 1
1 0 0 0 1 0 0 0 1 0 0 0 0 0 0 0 0 1 2 4
1 8 0 1 1 7 7 7 1 1 0 1 7 7 7 1 0 0 0 1
1 1 1 1 1 1 1 1 1 1 1 1 1 1 1 1 1 1 1 1


first line: width
second line: height

0 = air
1 = solid block
2 = CantSeeMe
3 = solid air
4 = ghost block
5 =
6 =
7 = spikes up
8 = player spawn
9 = door